########################################################################
# Configuração de Categorias por Mimetypes para indexação de diretórios
#
# Novos mimetypes devem ser definidos por assinatura ou extensão em
# CustomSignatures.jar/org/apache/tika/mime/custom-mimetypes.xml
#
########################################################################

Documentos RTF = application/rtf

Documentos PDF = application/pdf

Documentos HTML = text/html; application/xhtml+xml; application/vnd.wap.xhtml+xml; application/x-asp; text/asp; text/aspdotnet

Arquivos XML = application/xml; application/rdf+xml; application/rss+xml

Arquivos de Georeferenciamento = application/vnd.google-earth.kml+xml; application/gpx

Documentos de Texto = application/vnd.ms-wordml; application/x-tika-ooxml-protected-docx; application/vnd.apple.pages; application/msword; application/msword2; application/msword5; application/vnd.ms-word.document.macroenabled.12; application/vnd.ms-word.template.macroenabled.12; application/vnd.openxmlformats-officedocument.wordprocessingml.document; application/vnd.openxmlformats-officedocument.wordprocessingml.template; application/vnd.oasis.opendocument.text; application/vnd.oasis.opendocument.text-master; application/vnd.oasis.opendocument.text-template; application/vnd.oasis.opendocument.text-web; application/vnd.sun.xml.writer; application/vnd.sun.xml.writer.global; application/vnd.sun.xml.writer.template; application/vnd.stardivision.writer;

Planilhas = application/vnd.ms-spreadsheetml; application/x-tika-ooxml-protected-xlsx; text/csv; application/vnd.apple.numbers; application/vnd.ms-excel; application/vnd.ms-excel.addin.macroenabled.12; application/vnd.ms-excel.sheet.macroenabled.12; application/vnd.ms-excel.sheet.binary.macroenabled.12; application/vnd.ms-excel.template.macroenabled.12; application/x-tika-msworks-spreadsheet; application/vnd.openxmlformats-officedocument.spreadsheetml.sheet; application/vnd.openxmlformats-officedocument.spreadsheetml.template; application/vnd.oasis.opendocument.spreadsheet; application/vnd.oasis.opendocument.spreadsheet-template; application/vnd.sun.xml.calc; application/vnd.sun.xml.calc.template; application/vnd.stardivision.calc; application/x-tika-old-excel

Apresentações = application/x-tika-ooxml-protected-pptx; application/vnd.apple.keynote; application/x-corelpresentations; application/vnd.ms-powerpoint; application/vnd.ms-powerpoint.addin.macroenabled.12; application/vnd.ms-powerpoint.presentation.macroenabled.12; application/vnd.ms-powerpoint.slide.macroenabled.12; application/vnd.ms-powerpoint.slideshow.macroenabled.12; application/vnd.ms-powerpoint.template.macroenabled.12; application/vnd.openxmlformats-officedocument.presentationml.presentation; application/vnd.openxmlformats-officedocument.presentationml.slide; application/vnd.openxmlformats-officedocument.presentationml.template; application/vnd.openxmlformats-officedocument.presentationml.slideshow; application/vnd.oasis.opendocument.presentation; application/vnd.oasis.opendocument.presentation-template; application/vnd.sun.xml.impress; application/vnd.sun.xml.impress.template; application/vnd.stardivision.impress;

Arquivos OLE = application/x-tika-msoffice

Atalhos para arquivos = application/x-lnk

Outros Documentos = application/vnd.ms-xpsdocument; application/vnd.visio; application/vnd.ms-project; application/x-project; application/vnd.ms-works; application/x-quattro-pro; application/sldworks; application/x-tika-ooxml-protected; application/onenote; application/x-msmoney; application/x-mspublisher; application/x-ms-owner; model/vnd.dwfx+xps; application/vnd.ms-graph;

Emails = message/rfc822; message/x-emlx; application/vnd.ms-outlook; message/outlook-pst; application/x-ufed-html-mails; message/x-ufed-email

Caixas de Emails = application/vnd.ms-outlook-pst; application/outlook-dbx; application/mbox; application/x-incredimail

Bases de dados = application/x-edb; application/x-edb-table; application/irpf; application/x-msaccess; application/x-dbf; application/vnd.oasis.opendocument.database; application/x-sqlite3; application/x-mysql-db; application/x-berkeley-db; application/x-mssql-data;

Arquivos Compactados = application/x-tika-ooxml; application/zlib; application/applefile; application/vnd.ms-tnef; application/zip; application/x-rar-compressed; application/x-tar; application/gzip; application/x-gzip; application/x-xz; application/x-bzip; application/x-bzip2; application/x-7z-compressed; application/x-arj; application/x-gtar; application/x-archive; application/x-cpio; application/x-tika-unix-dump; application/x-snappy-framed; application/x-snappy; application/x-snappy-raw; application/x-compress; application/x-java-pack200; application/x-lzma; application/x-lz4; application/x-lz4-block; application/x-brotli; application/zstd; application/deflate64; image/x-emf-compressed 

Contatos = text/x-vcard; application/x-vcard-html; application/windows-adress-book; application/outlook-contact; application/x-livecontacts; application/x-livecontacts-table; contact/x-skype-contact; contact/x-skype-account; application/x-whatsapp-wadb; application/x-whatsapp-contactsv2; contact/x-whatsapp-contact; application/x-ufed-html-contacts; application/x-ufed-contact;

Chats = application/messenger-plus; application/messenger-chat; application/sqlite-skype; application/skype; application/x-whatsapp-db; application/x-whatsapp-chatstorage; message/x-whatsapp-msg; message/x-skype-conversation; message/x-skype-message; message/x-skype-filetransfer; application/x-ufed-html-chats; application/x-ufed-chats-txt; application/x-ufed-chat; application/x-ufed-chat-whatsapp; application/x-ufed-chat-preview

Registro do Windows = application/x-windows-registry; application/x-windows-registry-report

Programas e Bibliotecas = application/x-superfetch; application/x-elf-log; application/x-elf-file; application/x-prefetch; application/java-archive; application/x-dosexec; application/x-msdownload; application/x-bat; application/vnd.ms-cab-compressed; application/x-font-ttf; application/pkcs7-signature; application/vnd.ms-htmlhelp; application/java-vm; application/vnd.ms-pki.seccat; application/x-ms-installer; application/x-ufed-html-apps; application/x-ufed-installedapplication

Não Alocado = application/x-unallocated;

File Slacks = application/x-fileslack

Imagens = image; application/coreldraw; application/x-vnd.corel.zcf.draw.document+zip; application/vnd.oasis.opendocument.graphics; application/vnd.oasis.opendocument.graphics-template; application/vnd.oasis.opendocument.image; application/vnd.oasis.opendocument.image-template; application/vnd.sun.xml.draw; application/vnd.sun.xml.draw.template; application/vnd.stardivision.draw;

Vídeos = video; application/vnd.rn-realmedia; application/x-shockwave-flash

Áudios = audio;

Outros Textos = text

Outros Arquivos = application/octet-stream; application/x-nls

Peer-to-peer = application/x-p2p

Histórico de Internet = application/x-msie-cache; application/x-webcache; application/x-webcache-table; application/x-ufed-html-webhistory; application/x-firefox-places; application/x-firefox-history; application/x-firefox-downloads; application/x-chrome-sqlite; application/x-chrome-history; application/x-chrome-downloads; application/x-chrome-searches; application/x-edge-web-cache; application/x-edge-history; application/x-safari-sqlite; application/x-safari-history; application/x-safari-plist; application/x-safari-downloads; 

Registros de Histórico de Internet = application/x-ufed-visitedpage; application/x-firefox-history-registry; application/x-firefox-downloads-registry; application/x-chrome-history-registry; application/x-chrome-downloads-registry; application/x-edge-history-registry; application/x-safari-downloads-registry; application/x-safari-history-registry;

Favoritos Web = application/x-ufed-html-bookmarks; application/x-ufed-webbookmark; application/x-firefox-bookmarks; application/x-firefox-bookmarks-registry;

Discos ISO = application/x-iso9660-image; application/x-udf-image;

Discos Virtuais = application/x-wim-image; application/x-vmdk; application/x-vhd; application/x-vdi

Outros Espelhos = application/x-disk-image;

# UFED

Resumo da Extração = application/x-ufed-html-summary

Chamadas = application/x-ufed-html-calls; application/x-ufed-call

Mensagens SMS = application/x-ufed-html-sms; application/x-ufed-sms

Mensagens MMS = application/x-ufed-html-mms; application/x-ufed-mms

Mensagens Instantâneas = application/x-ufed-instantmessage

Dispositivos Bluetooth = application/x-ufed-html-bluetooth; application/x-ufed-bluetoothdevice

Dados SIM = application/x-ufed-html-simdata; application/x-ufed-simdata

Calendário = application/x-ufed-html-calendar; application/x-ufed-calendarentry

Logs = application/x-ufed-html-logs; application/x-ufed-logentry

Usuários = application/x-ufed-html-users; application/x-ufed-useraccount; application/x-ufed-user

Pesquisas = application/x-ufed-html-searches; application/x-ufed-searcheditem

Anotações = application/x-ufed-html-notes; application/x-ufed-note

Redes sem fio = application/x-ufed-html-wifi; application/x-ufed-wirelessnetwork

Notificações = application/x-ufed-html-notifications; application/x-ufed-notification

Localizações = application/x-ufed-html-locations; application/x-ufed-location

Cookies = application/x-ufed-html-cookies; application/x-ufed-cookie

Configurações = application/x-ufed-html-configurations

Senhas = application/x-ufed-html-passwords; application/x-ufed-password

Autopreenchimento = application/x-ufed-html-autofill; application/x-ufed-autofill

Torres de célula = application/x-ufed-html-celltowers; application/x-ufed-celltower

Eventos de Energia = application/x-ufed-html-energyevents; application/x-ufed-poweringevent

Dicionário do usuário = application/x-ufed-html-userdict; application/x-ufed-dictionaryword

Conexões IP = application/x-ufed-html-ips; application/x-ufed-ipconnection

Gravações = application/x-ufed-html-recordings; application/x-ufed-recording

Cartões Móveis = application/x-ufed-mobilecard

Uso de Aplicativos = application/x-ufed-applicationusage